8888888888888888888888888888888888888888888888888888888888888888888888888888888888888
8888888888888888888888888888888888888888888888888888888888888888888888888888888888888
8888888888888888888888888888888888888888888888888888888888888888888888888888888888888
1111111111111111111888888888888888888888888888888888888888888888881111111111111111111
1000000000000000001888888888888888888888888888888888888888888888881000000000000000001
1000000000000000001888888888888888888888888888888888888888888888881000000000000000001
1111111111110000001888888888888888888888888888888888888888888888881111111111100000001
1000000000110000001888888888888888888888888888888888888888888888881111111111100000001
1111111001111110001111111111111111111111111111111111111118888888881111111111100000001
1000000000000110001100000000000000000000000000000000000018888888881000000000000000001
1000000000000110001100000000000000000000110000000000000018888888881000000000000000001
1000000000000110001100000000000000000001100000000000000018888888881000000011111111111
1000000000000110001100000000000000000111111111110000000018888888881000000011111111111
1111111100000110001100000000000000000001100000000000000018888888881000000011111111111
1111111110000110001100000000000000000000110000000000000018888888881000000000000000001
1111111111001110011111111111111111110000000000000110000018888888881000000000000000001
1110111011101110111100000000000000110000000000000110000018888888881111111111111000001
1110111011101110111100000000000000110000000000000110000018888888881000000000000000001
1110111011101110111100000000000000110000000000000110000018888888881000000010000000001
1110111011101110111100000000000000110000000000000110000018888888881000000010000000001
1000000000000000001100000000000000000000000000000110000018888888881000000010000000001
1111111001111111111100000000000000000000000000000110000018888888881111111010111111111
1888881000018888881100011111111111111111111111111110000018888888888888881000018888888
1888881110018888881100000000000000000000000000000000000018888888888888881110018888888
1888881000018888881100000000000000000000000000000000000018888888888888881000018888888
1111111001111111111100000111000111111111111111111111100011111111111111111000011111111
1000000000000000001100000011000000000000000000001111100011000000000000000000000000001
1000000000000000001100000011000000000000000000000110000011000000000000000000000000001
1000000000000000001111110011111111111111111100000110000011000000000000000000000000001
1000000000000000000000000011000000000000000000000110000011000111100011111111111111111
1000000000000000000000000011000011111111111111111110000011000111100011111111111111111
1000000000000000001100000011000000000000000000000110000011000111100011111111111111111
1000000000000000001100000011000000000000000000000110000011000111100000000000000000001
1000000000000000001111100011000000000000000000000110000011000111100000000000000000001
1111111111111111111111100011111111111111111110000110000011000000000000000000000000001
8888888888888888881111100011000000000000000000000110000011111111111111111110000000001
8888888888888888881111100011000000000000000000000110000011111111111111111110000000001
8888888888888888881111100011000000000000000000000110000000000000000000000000000000001
8888888888888888881111100011000000111111111111111110000000000000000000000000000000001
1111111111111111111111100011000000000000000000000110000011000000000000000000000000001
0000000000000000000000000011000000000000000000000110000011000000000000000000000000001
1111111111111111111111100011000000000000000000000110000000000000000000000000000000001
8888888888888888881111100011111111111111111000000110000000000000000000000000000000001
8888888888888888881111100000000000000000000000000110000011000000000111111111111111111
8888888888888888881110000000000000000000000000001111100011000000000111111111111111111
8888888888888888881110001111111111111111111111111111100011000000000111111111111111111
1111111111111111111100000000000000000000000000000110000011000000000111111111111111111
1000000000000000001100000000000000000000000000000110000011000000000000000000000000001
1000000000000000001111111111111111111110000000000110000011000000000000000000000000001
1001111111111111111111111111111111111110000000000110000011111111111111111111000000001
1000011000000000000000000000000000000000000000000110000011111111111111111111000000001
1000011000000000000000000000000000000000000000000110000011000000000000000000000000001
1000011000000000001111111111111111111110000000000110000011000000000000000000000000001
1000011000000000001111111111111111111110000111111110000011000000000000000000000000001
1000000000000000001100000000000000000000000000000000000011000000000000000000000000001
1111111011111111111100000000000000000000000000000000001111111111111111111110111111111
1888881000018888881100000111111111111110000000000000001111888888888888881000018888888
1888881101018888881100000111111111111110000011111111111118888888888888881001118888888
1888881000018888881100000111111111111110000011111111111118888888888888881000018888888
1111111001111111111100000111111111111110000011111111111118888888881111111100111111111
1111111000000000001100000111111111111110000011111111111118888888881000000000000000001
1111111000000000001100000111111111111110000011111111111118888888881000000000000000001
1111111000000000001111111111111111000000000011111111111118888888881111111000111100111
1000000000000000001111111111111111000000111111111111111118888888881111111000111100111
1000000000000000001100000000000000000000000000000000000018888888881111111000111100111
1000111111111111111100111111111111111100000000000000000018888888881111111000111100111
1000111111111111111100111111111111111111111111111111000018888888881000000000111100001
1000000000000000001100111111111111111111111111111111000018888888881000000000111100001
1000000000000000001100000000000000000000000000000000000018888888881000000000111100001
1000000000000000001101111111111111111111111111111111100018888888881000000000111100001
1111111111111110001100000000000001111100000000000000000018888888881111100000111100001
1111111111111110001100000000000001111100000000000000000018888888881000000000111100001
1000000000000000001111111111111111111111111111111111111118888888881111100000111100001
1000000000000000001888888888888888888888888888888888888888888888881000000000111100001
1000111111111111111888888888888888888888888888888888888888888888881000000000111100001
1000111111111111111888888888888888888888888888888888888888888888881000000000111100001
1000000000000000001888888888888888888888888888888888888888888888881000000000000000001
1000000000000000001888888888888888888888888888888888888888888888881000000000000000001
1111111111111111111888888888888888888888888888888888888888888888881111111111111111111
8888888888888888888888888888888888888888888888888888888888888888888888888888888888888
8888888888888888888888888888888888888888888888888888888888888888888888888888888888888
8888888888888888888888888888888888888888888888888888888888888888888888888888888888888