08 08 08 08 08 08 08 08 08 08 08 08 08 08 08 08 08 08 08 09 08 08 08 08 08 08 08 08 08 08 08 08 08 08 08 08 08 08 08 08 08 08 08 08 08 08 08 08 08 08 08 08 08 08 08 08 08 08 08 08
08 08 08 08 08 08 08 08 13 12 13 12 12 13 13 12 13 12 12 09 12 12 13 12 13 12 13 12 13 12 12 08 08 08 08 08 08 08 08 08 08 08 08 08 08 08 08 08 08 08 08 08 08 08 08 08 08 08 08 08
08 08 08 08 08 08 12 08 12 13 12 12 13 12 12 13 12 12 13 09 12 13 13 12 13 12 12 13 12 13 12 08 08 12 08 12 08 08 08 08 08 12 08 08 08 08 12 08 08 08 08 08 12 08 08 08 08 08 08 08
08 08 08 08 08 08 08 08 08 08 08 12 08 08 08 08 08 08 08 09 08 08 13 08 12 08 08 08 08 08 08 08 08 08 08 08 08 08 08 08 08 08 08 08 08 08 08 08 08 08 08 08 08 08 08 08 08 08 08 08
08 08 08 13 08 13 08 08 13 08 08 08 08 08 12 08 08 14 14 16 14 14 13 08 13 08 08 08 08 12 08 08 08 12 08 08 08 12 08 08 13 08 08 08 08 08 12 08 08 08 12 08 08 12 08 08 08 08 08 08
08 08 08 08 08 08 12 08 08 08 13 08 08 08 08 13 08 15 15 16 15 15 13 08 12 08 08 08 12 08 08 08 08 08 13 08 08 08 08 13 08 08 08 12 08 08 08 08 13 08 08 08 08 08 08 08 08 08 08 08
08 13 08 12 08 08 08 08 12 08 13 08 12 08 08 12 08 14 08 09 08 14 08 12 08 13 08 13 08 08 12 08 08 12 08 08 12 08 13 08 12 08 08 08 12 08 13 08 12 08 12 08 08 12 08 08 08 08 08 08
08 08 08 08 08 08 08 08 08 08 08 08 08 08 08 08 08 14 08 09 08 14 08 08 08 08 08 08 08 08 08 08 08 08 08 08 08 08 08 08 08 08 08 08 08 08 08 08 08 08 08 08 08 08 08 08 08 08 08 08
08 13 08 08 01 01 01 01 01 01 01 01 01 01 01 01 01 01 01 07 01 01 01 01 01 01 01 01 01 01 01 01 01 01 01 01 01 01 01 01 01 01 01 01 01 01 01 01 01 01 01 01 01 01 08 08 08 08 08 08
08 08 12 08 01 01 01 01 01 01 01 06 00 01 01 01 01 01 00 00 00 01 01 01 01 01 01 01 01 01 01 01 01 01 01 01 01 01 01 01 01 01 01 01 01 01 01 01 01 01 01 01 01 01 08 12 08 08 13 08
08 08 08 08 01 01 01 01 01 01 01 00 00 01 01 01 01 01 00 00 00 01 01 01 01 01 01 00 00 00 00 00 00 00 00 00 00 02 01 01 01 01 01 01 01 01 01 01 01 01 01 01 01 01 08 08 08 08 08 08
08 12 08 08 01 01 01 01 01 01 00 00 00 00 01 01 01 00 00 00 00 00 01 01 01 01 01 00 00 00 00 00 00 00 00 00 00 00 01 01 01 01 01 01 01 01 01 01 01 01 01 01 01 01 08 13 08 08 13 08
08 12 08 08 01 01 01 01 01 00 00 00 00 00 00 00 00 00 00 00 00 00 00 01 01 00 00 00 00 04 00 00 00 00 00 00 00 00 01 01 01 01 01 01 01 01 01 01 01 01 01 01 01 01 08 12 08 08 08 08
08 08 13 08 01 01 01 01 01 00 00 00 00 00 00 00 00 00 00 00 00 00 00 01 01 00 00 00 00 00 01 01 01 01 01 01 01 01 01 01 01 01 01 01 01 01 01 01 01 01 01 01 01 01 08 08 08 08 08 08
08 08 08 08 01 01 01 01 01 01 00 00 00 00 01 01 00 00 01 01 00 00 00 01 01 00 00 00 00 03 01 01 01 01 01 01 01 01 01 01 01 01 01 01 01 01 01 01 01 01 01 01 01 01 08 13 08 08 08 08
08 08 12 08 01 01 01 01 01 01 01 00 00 01 01 01 00 00 01 01 00 00 00 01 01 00 04 00 00 00 00 01 01 01 01 01 01 01 01 01 01 01 01 01 01 01 01 01 01 01 01 01 01 01 08 12 08 08 08 08
08 08 08 08 01 01 01 01 01 01 01 00 00 01 01 00 00 00 01 01 00 00 00 01 01 00 00 00 00 00 00 00 01 01 01 01 01 01 01 01 00 05 00 01 01 01 01 01 01 01 01 01 01 01 08 08 08 08 13 08
08 12 08 08 01 01 01 01 01 01 01 00 00 00 00 00 11 00 01 01 00 00 00 01 01 00 00 00 00 00 00 00 00 00 00 01 01 01 01 01 00 00 00 01 01 01 01 01 01 01 01 01 01 01 08 12 08 08 08 08
08 08 13 08 01 01 01 00 00 00 00 00 00 00 00 00 00 00 01 01 00 00 00 01 01 00 00 00 00 00 00 00 00 00 01 01 01 01 01 00 00 00 00 00 01 01 01 01 01 01 01 01 01 01 08 08 12 08 08 08
08 08 08 08 01 01 01 03 00 00 00 00 00 00 00 00 00 00 01 01 00 00 00 01 01 00 00 00 00 00 00 00 00 01 01 01 01 01 00 04 00 00 00 00 00 01 01 01 01 01 01 01 01 01 08 08 13 08 08 08
08 08 13 08 01 01 01 00 00 00 01 01 01 01 00 00 01 01 01 01 00 00 00 01 01 00 00 00 00 00 00 00 01 01 01 01 01 00 00 00 00 00 00 00 00 00 01 01 01 01 01 01 01 01 08 08 12 08 08 08
08 12 08 08 01 01 01 00 00 00 01 01 01 01 00 00 01 01 01 01 00 00 00 01 01 00 00 00 00 00 00 01 01 01 01 01 01 00 00 00 00 00 00 00 00 00 01 01 01 01 01 01 01 01 08 08 08 13 08 08
08 08 08 08 01 01 01 01 00 00 00 00 00 00 00 00 01 01 01 01 00 00 00 00 00 00 00 00 00 00 01 01 01 01 01 01 01 00 00 00 00 00 00 00 00 00 01 01 01 01 01 01 01 01 08 12 08 12 08 08
08 13 08 08 01 01 01 01 01 00 00 00 00 00 00 00 01 01 01 01 00 00 00 00 00 00 00 00 01 01 01 01 08 08 01 01 01 00 00 00 00 00 00 00 00 00 00 00 00 01 01 01 01 01 08 13 08 13 08 08
08 12 08 08 01 01 01 01 01 01 01 01 01 00 00 01 01 01 01 01 01 01 00 00 00 00 00 00 01 08 08 08 08 08 01 01 01 00 00 00 00 00 00 00 00 00 00 00 00 00 01 01 01 01 08 08 12 08 08 08
08 08 13 08 01 01 01 01 01 01 01 01 01 00 00 01 01 01 01 01 01 01 00 00 00 00 00 00 01 08 08 08 08 08 01 01 01 00 00 00 00 00 00 00 00 00 00 00 00 00 00 01 01 01 08 08 08 08 13 08
08 08 12 08 01 01 01 01 01 01 01 01 01 00 00 01 01 01 01 01 01 01 00 00 00 00 00 00 01 08 08 08 08 08 00 00 00 00 00 00 00 04 00 00 00 00 00 00 00 00 00 01 01 01 08 12 08 13 08 08
13 08 08 08 01 01 01 01 01 01 01 01 01 00 00 01 01 01 01 01 01 01 00 00 00 00 00 00 01 08 08 08 08 08 00 00 00 00 00 00 00 00 00 00 00 00 00 00 00 00 00 01 01 01 08 08 08 12 08 08
08 12 08 08 01 01 01 01 01 01 01 01 01 00 00 01 01 01 01 01 01 01 00 00 00 00 00 00 01 01 01 01 01 01 01 01 01 00 00 00 00 00 00 00 00 00 00 00 00 00 03 01 01 01 08 08 08 08 08 08
08 08 13 08 01 01 01 01 01 01 01 01 01 00 00 01 01 01 01 01 01 00 00 00 00 00 00 00 00 01 01 01 01 01 01 01 01 00 00 00 00 00 00 00 00 00 00 00 00 00 00 01 01 01 08 08 12 08 08 08
08 08 08 08 01 01 01 01 01 01 01 01 01 00 00 01 01 01 01 01 00 00 00 00 04 00 00 00 00 00 00 00 00 00 00 00 00 00 00 00 00 00 00 00 00 00 00 00 00 00 00 01 01 01 08 08 13 08 13 08
08 13 08 08 01 01 01 01 01 01 01 01 00 00 00 00 01 01 01 01 00 00 00 00 00 00 00 00 00 00 00 00 00 00 00 00 00 00 00 00 00 00 00 00 00 00 00 00 00 00 00 01 01 01 08 12 08 08 12 08
08 08 12 08 01 01 01 01 01 01 01 00 00 00 00 00 00 01 01 01 01 00 00 00 00 00 00 00 00 01 01 01 01 01 01 01 01 00 00 00 00 00 00 00 00 00 00 00 00 00 00 01 01 01 08 08 08 08 08 08
08 13 08 08 01 01 01 01 01 01 00 00 00 00 00 00 00 00 01 01 01 01 00 00 00 00 00 00 01 01 01 01 01 01 01 01 01 00 00 00 00 00 00 00 00 00 00 00 00 00 00 01 01 01 08 12 08 08 08 08
08 08 08 08 01 01 01 01 01 00 00 00 00 00 03 00 00 00 00 01 01 01 01 00 00 00 00 01 01 22 08 08 08 08 00 00 00 00 00 00 00 00 00 00 00 00 00 00 00 00 00 01 01 01 08 08 08 13 08 08
08 12 08 08 01 01 01 01 01 00 00 00 00 00 00 00 00 00 00 01 01 01 01 00 00 00 00 01 01 08 08 08 08 08 00 00 00 00 00 00 00 00 00 00 00 00 00 00 00 00 01 01 01 01 08 12 08 12 08 08
08 08 08 08 01 01 01 01 01 00 00 00 00 00 00 00 00 00 00 01 01 01 01 00 00 00 00 01 01 08 08 08 08 08 01 01 01 00 00 00 00 00 00 00 00 00 00 00 00 01 01 01 01 01 08 08 08 08 08 08
08 13 12 08 01 01 01 01 01 00 00 00 00 00 00 00 00 00 00 01 01 01 01 00 00 00 00 01 01 08 08 08 08 08 01 01 01 00 00 00 00 00 00 00 00 00 01 01 01 01 01 01 01 01 08 12 08 12 08 08
08 08 08 08 01 01 01 01 01 00 00 00 00 00 00 00 00 00 00 01 01 01 01 00 00 00 00 01 01 08 08 08 08 08 01 01 01 00 00 00 00 00 00 00 00 00 01 01 01 01 01 01 01 01 08 08 08 08 08 08
08 08 13 08 01 01 01 01 01 00 00 00 04 00 00 00 00 00 00 01 01 01 01 00 00 00 00 01 01 01 01 01 01 01 01 01 01 00 00 00 00 00 00 00 00 00 01 01 01 01 01 01 01 01 08 13 12 08 08 08
08 12 08 08 01 01 01 01 01 01 01 01 01 00 00 00 01 01 01 01 01 01 00 00 00 00 00 00 01 01 01 01 01 01 01 01 01 01 00 00 00 03 00 00 00 01 01 01 01 01 01 01 01 01 08 08 08 08 08 08
08 08 13 08 01 01 01 01 01 01 02 00 00 00 00 00 00 00 00 00 00 00 00 00 00 00 00 00 00 00 00 00 00 00 00 01 01 01 01 00 04 00 00 00 01 01 01 01 01 01 01 01 01 01 08 08 08 12 08 08
08 08 08 08 01 01 01 01 01 01 01 01 04 00 00 00 00 00 00 00 00 00 00 00 00 00 00 00 00 00 00 00 00 00 00 01 01 01 01 01 00 00 00 01 01 01 01 01 01 01 01 01 01 01 08 12 08 08 08 08
08 13 12 08 01 01 01 01 01 01 01 01 01 01 01 01 01 01 01 01 01 01 00 00 00 00 00 00 01 01 01 01 01 00 00 01 01 01 01 01 01 00 00 01 01 01 01 01 01 01 01 01 01 01 08 08 08 12 08 08
08 08 08 08 01 01 01 01 01 01 01 01 01 01 01 01 01 01 01 01 01 01 01 00 00 00 00 01 01 01 01 01 01 00 00 01 01 01 01 01 01 00 00 01 01 01 01 01 01 01 01 01 01 01 08 08 13 08 08 08
08 12 08 08 01 01 01 01 01 01 01 01 01 01 01 01 01 01 01 01 01 01 01 00 00 00 00 01 01 01 01 01 01 00 00 01 01 01 01 01 01 00 00 01 01 01 01 01 01 01 01 01 01 01 08 12 08 12 08 08
08 13 08 08 01 01 01 01 01 01 01 01 01 01 01 01 00 00 00 00 00 00 00 00 00 00 00 01 01 01 01 01 01 00 00 01 01 01 01 01 01 00 00 01 01 01 01 01 01 01 01 01 01 01 08 08 08 08 08 08
08 08 08 08 01 01 01 01 01 01 01 01 01 01 01 01 03 00 00 00 00 00 00 00 00 00 00 01 01 01 01 01 01 00 00 00 00 00 00 00 00 02 00 01 01 01 01 01 01 01 01 01 01 01 08 12 08 12 08 08
08 12 08 08 01 01 01 01 01 01 01 01 01 01 01 01 00 00 00 00 00 01 01 00 00 00 00 01 01 01 01 01 01 00 00 00 00 00 00 00 00 00 00 01 01 01 01 01 01 01 01 01 01 01 08 08 08 13 08 08
08 08 13 08 01 01 01 01 01 01 01 00 00 01 01 01 00 00 00 00 00 01 01 00 00 00 00 01 01 01 01 01 01 04 00 00 00 00 00 00 00 00 01 01 01 01 01 01 01 01 01 01 01 01 08 08 12 08 08 08
08 08 08 08 01 01 01 01 01 01 00 00 00 00 01 01 01 01 01 01 01 01 01 00 00 00 00 01 01 01 01 01 01 00 00 00 00 00 00 00 00 00 01 01 01 01 01 01 01 01 01 01 01 01 08 08 08 08 08 08
13 08 12 08 01 01 01 01 01 02 00 00 00 00 00 00 00 00 00 00 00 00 00 00 00 00 00 01 01 01 01 01 01 01 01 01 01 01 01 01 00 00 01 01 01 01 01 01 01 01 01 01 01 01 08 12 08 13 08 08
08 08 08 08 01 01 01 01 01 00 00 00 00 00 00 00 00 00 00 00 00 00 00 00 00 00 00 01 01 01 01 01 01 01 01 01 01 01 01 01 00 00 01 01 01 01 01 01 01 01 01 01 01 01 08 08 08 08 08 08
13 08 13 08 01 01 01 01 01 01 04 00 00 00 01 01 01 01 01 01 01 01 01 00 00 00 00 00 00 00 00 00 00 00 00 00 00 00 00 00 00 00 01 01 01 01 01 01 01 01 01 01 01 01 08 08 12 08 08 08
08 12 12 08 01 01 01 01 01 01 01 00 00 01 01 01 01 01 01 01 01 01 01 04 00 00 00 00 00 00 00 00 00 00 00 00 00 00 00 00 00 03 01 01 01 01 01 01 01 01 01 01 01 01 08 13 08 08 08 08
08 08 08 08 01 01 01 01 01 01 01 01 01 01 01 01 01 01 01 01 01 01 01 01 01 01 01 01 01 01 01 01 01 01 01 01 01 01 01 01 01 01 01 01 01 01 01 01 01 01 01 01 01 01 08 08 12 08 08 08
08 13 08 08 01 01 01 01 01 01 01 01 01 01 01 01 01 01 01 01 01 01 01 01 01 01 01 01 01 01 01 01 01 01 01 01 01 01 01 01 01 01 01 01 01 01 01 01 01 01 01 01 01 01 08 12 08 08 08 08
08 12 08 08 01 01 01 01 01 01 01 01 01 01 01 01 01 01 01 01 01 01 01 01 01 01 01 01 01 01 01 01 01 01 01 01 01 01 01 01 01 01 01 01 01 01 01 01 01 01 01 01 01 01 08 08 08 08 13 08
08 08 08 08 08 08 08 08 08 08 08 08 08 08 08 08 08 08 08 08 08 08 08 08 08 08 08 08 08 08 08 08 08 08 08 08 08 08 08 08 08 08 08 08 08 08 08 08 08 08 08 08 08 08 08 08 08 12 08 08
08 08 08 12 08 08 08 12 08 08 08 08 08 13 08 08 08 12 08 08 08 13 08 08 12 08 08 08 08 13 08 08 08 08 08 08 08 08 08 12 08 08 08 08 08 12 08 08 08 08 08 12 08 08 08 08 08 08 08 08
08 13 08 08 08 13 08 08 08 13 08 12 08 08 12 08 08 08 08 08 08 12 08 08 08 08 13 08 08 08 12 08 08 08 12 08 08 08 12 08 08 08 13 08 08 08 08 08 13 08 12 08 08 08 12 08 08 08 08 08
08 08 08 08 08 08 08 08 12 08 08 08 08 08 13 08 08 08 08 12 08 08 08 08 08 08 08 08 08 08 08 08 08 08 08 13 08 08 08 08 13 08 08 13 08 12 08 08 08 12 08 08 08 08 08 08 08 08 08 08
08 08 08 08 08 08 08 08 08 08 08 08 08 08 08 08 08 08 08 08 08 08 08 08 08 08 08 08 08 08 08 08 08 08 08 08 08 08 08 08 08 08 08 08 08 08 08 08 08 08 08 08 08 08 08 08 08 08 08 08
08 08 08 08 08 08 08 08 08 08 08 08 08 08 08 08 08 08 08 08 08 08 08 08 08 08 08 08 08 08 08 08 08 08 08 08 08 08 08 08 08 08 08 08 08 08 08 08 08 08 08 08 08 08 08 08 08 08 08 08
08 08 08 08 08 08 08 08 08 08 08 08 08 08 08 08 08 08 08 08 08 08 08 08 08 08 08 08 08 08 08 08 08 08 08 08 08 08 08 08 08 08 08 08 08 08 08 08 08 08 08 08 08 08 08 08 08 08 08 08
08 08 08 08 08 08 08 08 08 08 08 08 08 08 08 08 08 08 08 08 08 08 08 08 08 08 08 08 08 08 08 08 08 08 08 08 08 08 08 08 08 08 08 08 08 08 08 08 08 08 08 08 08 08 08 08 08 08 08 08